GM 1
LMT 40
MNS 0/79/0
3 3 3 3 3 3 3 3
2 1 1 2 2 1 1 2
2 1 1 2 2 1 1 2
2 2 2 2 2 2 2 2
4 4 4 4 4 4 4 4
2 2 2 0 0 2 2 2
2 4 2 0 0 2 4 2
2 4 2 0 0 2 4 2
2 4 2 0 0 2 4 2
2 2 2 0 0 2 2 2