GM 1
LMT 40
MNS 0/48/0
3 3 3 0 0 2 2 2
3 2 3 0 0 1 2 1
2 2 2 0 0 1 2 1
2 2 2 0 0 1 2 1
2 2 2 0 0 2 2 2
0 0 0 0 0 0 0 0
2 2 2 0 0 2 2 2
3 2 3 0 0 2 3 2
3 2 3 0 0 2 3 2
2 2 2 0 0 2 2 2