GM 0
LMT 40
MNS 0/36/0
0 2 2 2 2 2 2 0
0 0 2 2 2 2 0 0
0 0 0 2 2 0 0 0
0 0 0 0 0 0 0 0
0 0 0 3 3 0 0 0
0 0 2 3 3 2 0 0
0 2 2 3 3 2 2 0
2 2 2 3 3 2 2 2
0 2 2 0 0 2 2 0
0 0 0 0 0 0 0 0